11111111111
1000C00C001
10P0000C001
100000000E1
11111111111